###################
#          #o     #
#######    ###    #
#o             ####
#  # o    ##      #
#  ##  #####  ##  #
#                 #
###################
