###################
#P         #o     #
#######C   ###    #
#o             ####
#  # o    ##  C   #
#  ##C #####  ##  #
#                 #
###################
