#################
#P        #    o#
#####   C##     #
#o           ####
# C##  #####    #
#  ##o #####C   #
#               #
#################
