###########################
#P             #o         #
######       ###          #
# o              C   #### #
#  ###  #####     #########
#    ##  ####         #####
#              ##   o   ###
#  C####   C  ######      #
#      #     ### C        #
#           o             #
###########################






