###########################
#P                       ##
######       ###          #
#     C       o       #####
# ## #  #####   #   #   ###
#   ##   ####   C     #  ##
#        #          o   # #
#   ####   C  ######     ##
# o         ###          ##
### ###              #   ##
#     C   ###     o  ##  ##
# ### o  #       C   #    #
#   ##  ######        o#  #
#      C    o             #
###########################


